111111
100101
102001
1100N1
1000N1
111111