11111111
10010001
10201001
1010N001
1000N001
11111111