1111111
1001001
1020001
1100N01
1000N01
1111111